00000000000000000000
00000000000000000000
01111111110000111100
00000000000000000000
00000000000000000000
00000001111111111111
00000000000000000000
00000000000000000000
00111100000000111100
00000000000000000000
00000000000000000000
11111111111111111111
